####                
####  ~~~~~~~~~~~~~ 
####  ~~~~~~~~~~~~~ 
####  ~~~~~~~~~~~~~ 
####  ~~~~~~~~~~~~~ 
#S    ~~~~~~~~~~~~~E
##### ~~~~~~~~~~~~~ 
##### ~~~~~~~~~~~~~ 
##### ~~~~~~~~~~~~~ 
##### ~~~~~~~~~~~~~ 
#####               